R       640 480
NO     ./textures/spring.xpm
SO       ./textures/autumn.xpm
WE   ./textures/summer.xpm
EA  ./textures/winter.xpm

S   ./textures/oldcry2.xpm
F    255,255,255
C   0,255,255

1111111111111111111111111111111111
1000000011
100000000111
10020000111
10000001
1000N001
10000001
1111111111111111111111111111111111
