R              1 10
NO     ./path_to_the_north_texture   
SO       ./path_to_the_south_texture
WE   ./path_to_the_west_texture
EA  ./path_to_the_east_texture


S   ./path_to_the_sprite_texture
F    255,12,1
C   225,30,0

11111111111
12222222221
122222222221
12222222221
10000200101
11100N02001
11111111111