R 200 200
NO ./textures/eagle.xpm
SO ./textures/greystone.xpm
WE ./textures/redbrick.xpm
EA ./textures/purplestone.xpm

S ./textures/barrel.xpm
F 255,255,255
C 30,30,255

11111111111111111111111111111111111
1S100000000000000000000000000011111
10121010011101111011111111111100111
10111000000000000000000000000000001
10000000000010111111110000000000001
11111011011010100011110111000001111
11111000011000101111110111111111111
10000111111011001111110000000000001
10110000000010010000010111101110111
10111111111110111111010111101110111
10111101111110111111000110001100111
10000000000000000000000111111111111
11111111111111111111111111111111111