R 10000 10000000
NO ./textures/summer.xpm
SO ./textures/winter.xpm
WE ./textures/spring.xpm
EA ./textures/autumn.xpm

S ./textures/oldcry2.xpm
F 255,255,255
C 200,255,255

11111111
10000001
10000001
10000001
1000N001
10000001
10000001
11111111
