R 300 300
NO ./textures/eagle.xpm
SO ./textures/greystone.xpm
WE ./textures/redbrick.xpm
EA ./textures/purplestone.xpm

S ./textures/barrel.xpm
F 255,255,255
C 30,30,255

11111111111    11111111
10000000000111100000001
10020200000000000000001
10002020000111100000001
10000W20000111100000001
10000000000111100000001
10000000000000000000001
10000000000111100000001
11111111111111111111111